111111111111111111111111111111111
111111111111111121111111111111111
111111111111111101111111111111111
111111111111111101111111111111111
111111111111111101111111111111111
111111111111111101111111111111111
111111111111111101111111111111111
111111111111111101111111111111111
111111111111111101111111111111111
111111111111111101111111111111111
111111111111111101111111111111111
111111111111111101111111111111111
111111111111111101111111111111111
111111111111111101111111111111111
111111111111111101111111111111111
111111111111111101111111111111111
120000000000000AP0000000000000021
111111111111111101111111111111111
111111111111111101111111111111111
111111111111111101111111111111111
111111111111111101111111111111111
111111111111111101111111111111111
111111111111111101111111111111111
111111111111111101111111111111111
111111111111111101111111111111111
111111111111111101111111111111111
111111111111111101111111111111111
111111111111111101111111111111111
111111111111111101111111111111111
111111111111111101111111111111111
111111111111111101111111111111111
111111111111111121111111111111111
111111111111111111111111111111111