111111111111111111
112111111111112211
110100000000010011
110000000000010011
120100003P00000011
110000000000010011
110100000000010011
112111111111112211
111111111111111111