11111111111111111111111111
11111111111111212111121111
120000000000010100000000111
120000000000000101000000111
1200000000000101011000000011
12000000000111010111101111111
111111111111110100000000APA11
12000000000111010111101111111
1200000000000100011000000011
120000000000000101000000011
120000000000010100000000111
11111111111111212111121111
11111111111111111111111111